###########################
#         #     #        B#
# # ##### ##### # # #### ##
# # #           # #       #
### ## ###### ### #### ## #
#   #       #     #   #   #
# # # ##### ### ##### # ###
# # #     #               #
# ####### ######### ####  #
#       #     #   #       #
# # # # ### ### # # #######
# # # #     #   # #       #
# # ### ##### ###   ### # #
# #   #     # # # #     # #
# ### ### # ### # ##### # #
#   #   # #     #       # #
### # ### ##### #### ## # #
# # #   #     #       #   #
# # ### ##### # ##  # ## ##
#     # #     #       #   #
# ##### # #### ## # # ### #
#   #   #   #       #     #
### #    ## # ### # ##### #
#   # # #   # #   #   #   #
# ### ### ### # ##### # ###
#A  #         #       #   #
###########################
