#######################################################
#   #       #           #       #   #   #         #  B#
# # ####### # ##### ### # ##### # # # # # ### ### ### #
# #       # #     # # #   #   # # #   # # # # #     # #
# ####### # # ##### # ####### # ### ### # # # ##### # #
# #   #   #   #     #         #   # #   #   #   # # # #
# # # # ### ### ##### # ##### ### # # ##### ### # # # #
# # # #   # #   #   # #   #     # # #     # #   # # # #
# # # ### # # ### # # ### ### ### # ##### # # ### # # #
# # # #   # #   # # #   #   # #   #     #   # #   #   #
# ### # ####### # ### ##### # # ####### ##### # ##### #
#   # #     #   # #   #     # #       #   #   #   #   #
### # ##### # ### # ### ############# ### # ### # # ###
#   #     # # # #     #             #   # # #   #     #
# ### # # # # # # ####### ####### ##### ### # ####### #
# # # # # #   #   #     #     #   #     #   # #     # #
# # # # ####### ### ### ##### # # # ##### ##### ### # #
# # # #       # # #   #   #   # # #   #   #   # # # # #
# # # ####### # # ### ### # ### # ### # # # # # # # # #
# #       #   # #   # #   # # # #   # # # # #   # # # #
# ######### ### ### # # ### # # ### # # # # ##### # # #
#   #     #         # # # #   # #   # # #         # # #
### # ### ### ##### # # # ### # ### # # ########### # #
#   #   #   # #   # # # #   # #   # # #     #     # # #
# ##### ### ### # # # # ### # ### ### ####### ### # ###
#     #   #   # # # # #   #     #     #       #   #   #
### ##### ### # # ### ### ##### ####### ####### ### # #
#   #   #   # # #     # # # #   #       #     # #   # #
# ### # ### # # ####### # # # ### ### ####### # ##### #
#     # #   #   #       #   # # #   # #       #       #
####### # ####### ### ####### # ### # ### ########### #
#     #   #     # # #         # #   #   # #       #   #
# # ####### # # # # ########### # ##### # # # ##### ###
# # #       # # #   #     # #     #     #   #   #   # #
# ### ####### ##### # # # # # ##### ##### ##### # ### #
#     #     #       # # #   #   #   #   #   #   #   # #
# ##### ### ########### ### ### # ### ##### # ##### # #
#   #     # #           #     # # #       # #     #   #
### # ### # ####### ########### # # ##### # ##### ### #
#   #   # #       #   #         # # # #   # #     #   #
# ##### # ####### # # # ######### # # # ### # ### # ###
# #   # #       # # # #       #   # # #     # #   #   #
# # ### ####### # ### ### ##### ### # ####### ####### #
# #   # #       #   #     #     # # #   #   #       # #
# ### # # ######### # ##### ##### # # # ### ##### ### #
#   #   # #       # #   #   # #   #   # #   #   #   # #
### # ### # ####### # ### ### # # ##### # # ### ### # #
#   # # # #   #     # #   #   # #     #   #   #   #   #
# ### # # ### # ####### ### # # ##### ####### # # #####
#   #   #   # # #       #   # # #   #   #   # # #     #
### ####### # # # ####### # ### # ##### # # # ### ### #
# # #   #   # # #   # #   #   #   #     # # #   # #   #
# # # # # ### # ### # # ##### ### # ##### # ### ### # #
#A    #   #         #       #     #       #         # #
#######################################################
